2l2w0l2w2l2w0l2w0l2w0l2w2l2w0l2w0l2w2l2w0l2w0l2w0l2w0l2w0l2w0l2w0l2w
2l0w2l0w0l2w0l2w0l2w0l0w0l0w2l2w0l0w2l0w0l0w0l0w0l0w0l0w0l0w0l0w0l2w
2l0w2l2w0l0w2l2w0l2w2l0w2l2w0l2w2l0w2l0w0l0w0l0w0l0w0l0w0l0w0l0w0l0w
2l0w2l0w0l2w2l0w0l0w2l0w2l0w0l2w2l0w2l0w0l0w0l0w0l0w0l0w0l0w0l0w0l0w
2l0w0l2w2l0w0l2w0l0w2l0w2l2w0l0w2l0w2l0w0l0w0l0w0l0w0l0w0l0w0l0w0l0w
2l0w0l2w2l0w0l2w2l0w2l0w2l0w0l2w2l0w2l0w0l0w0l0w0l0w0l0w0l0w0l0w0l0w
2l2w0l0w0l2w2l0w0l0w2l0w0l2w0l0w2l0w2l0w0l0w0l0w0l0w0l0w0l0w0l0w0l0w
2l0w2l2w0l0w0l2w2l2w2l2w0l2w0l2w0l0w2l0w0l0w0l0w0l0w0l0w0l0w0l0w0l0w
2l0w0l0w0l2w0l0w0l0w0l0w0l2w0l0w0l2w2l0w0l0w0l0w0l0w0l0w0l0w0l0w0l0w
2l2w0l2w0l2w0l2w0l2w0l2w0l2w0l2w0l2w0l0w0l0w0l0w0l0w0l0w0l0w0l0w0l0w
2l0w0l0w0l0w0l0w0l0w0l0w0l0w0l0w0l0w0l0w0l0w0l0w0l0w0l0w0l0w0l0w0l0w
2l0w0l0w0l0w0l0w0l0w0l0w0l0w0l0w0l0w0l0w0l0w0l0w0l0w0l0w0l0w0l0w0l0w
2l0w0l0w0l0w0l0w0l0w0l0w0l0w0l0w0l0w0l0w0l0w0l0w0l0w0l0w0l0w0l0w0l0w
2l0w0l0w0l0w0l0w0l0w0l0w0l0w0l0w0l0w0l0w0l0w0l0w0l0w0l0w0l0w0l0w0l0w
2l0w0l0w0l0w0l0w0l0w0l0w0l0w0l0w0l0w0l0w0l0w0l0w0l0w0l0w0l0w0l0w0l0w
2l0w0l0w0l0w0l0w0l0w0l0w0l0w0l0w0l0w0l0w0l0w0l0w0l0w0l0w0l0w0l0w0l0w
2l0w0l0w0l0w0l0w0l0w0l0w0l0w0l0w0l0w0l0w0l0w0l0w0l0w0l0w0l0w0l0w0l0w
