*===*===*===*===*===*===*===*===*===*===*===*===*===*===*===*===*===*   
|                       |           |                               |   
*   *===*===*===*   *   *   *===*   *   *   *   *   *   *   *   *   *   
|       |       |   |       |       |                               |   
*===*   *   *   *===*===*   *   *   *   *   *   *   *   *   *   *   *   
|   |       |           |       |   |                               |   
*   *   *===*===*   *   *===*   *   *   *   *   *   *   *   *   *   *   
|   |   |       |   |       |       |                               |   
*   *   *   *   *   *===*   *===*   *   *   *   *   *   *   *   *   *   
|   |   |                   |       |                               |   
*   *   *===*===*===*===*===*===*   *   *   *   *   *   *   *   *   *   
|                           |       |                               |   
*===*   *===*===*===*===*   *   *   *   *   *   *   *   *   *   *   *   
|       |       |       |   |   |   |                               |   
*   *===*   *   *   *   *   *   *   *   *   *   *   *   *   *   *   *   
|   |   |   |       |       |       |                               |   
*   *   *===*===*===*===*===*   *   *   *   *   *   *   *   *   *   *   
|                               |   |                               |   
*===*===*===*===*===*===*===*===*===*   *   *   *   *   *   *   *   *   
|                                                                   |   
*   *   *   *   *   *   *   *   *   *   *   *   *   *   *   *   *   *   
|                                                                   |   
*   *   *   *   *   *   *   *   *   *   *   *   *   *   *   *   *   *   
|                                                                   |   
*   *   *   *   *   *   *   *   *   *   *   *   *   *   *   *   *   *   
|                                                                   |   
*   *   *   *   *   *   *   *   *   *   *   *   *   *   *   *   *   *   
|                                                                   |   
*   *   *   *   *   *   *   *   *   *   *   *   *   *   *   *   *   *   
|                                                                   |   
*   *   *   *   *   *   *   *   *   *   *   *   *   *   *   *   *   *   
|                                                                   |   
*   *   *   *   *   *   *   *   *   *   *   *   *   *   *   *   *   *   
|   |                                                               |   
*===*===*===*===*===*===*===*===*===*===*===*===*===*===*===*===*===*   
                                                                        
