*===*===*===*===*===*===*===*===*===*===*===*===*===*===*===*===*   
|                                                               |   
*   *===*===*===*===*===*===*===*===*===*===*===*===*===*===*   *   
|   |                                                       |   |   
*   *   *===*===*===*===*===*===*===*===*===*===*===*   *===*   *   
|   |   |       |                                   |       |   |   
*   *   *   *   *   *   *===*===*===*===*   *===*   *===*   *   *   
|   |   |   |   |   |                       |   |       |       |   
*   *   *   *   *   *===*   *===*===*   *===*   *===*   *===*   *   
|   |   |   |   |       |       |       |           |       |   |   
*   *   *   *   *   *===*===*   *   *===*   *   *===*   *===*   *   
|   |   |   |   |           |       |       |           |   |   |   
*   *   *   *   *   *===*===*   *   *===*   *===*   *===*   *===*   
|   |   |   |   |       |       |       |       |   |           |   
*   *   *   *   *   *===*   *===*===*   *===*   *===*===*   *===*   
|   |   |   |       |       |       |       |       |           |   
*   *   *   *   *===*   *===*   *   *===*   *===*   *   *===*   *   
|   |   |   |   |       |               |       |       |       |   
*   *   *   *===*   *===*   *===*===*   *===*   *===*===*   *===*   
|   |       |       |   |       |       |   |       |           |   
*   *   *===*   *===*   *===*   *   *===*   *===*   *===*   *===*   
|   |   |       |           |       |           |       |       |   
*   *===*   *   *   *   *===*   *   *===*   *   *===*   *===*   *   
|   |       |       |           |           |       |       |   |   
*   *===*   *   *===*===*   *===*===*   *===*===*   *   *===*   *   
|   |           |   |           |           |   |       |       |   
*   *===*   *   *   *   *===*   *   *===*   *   *   *===*   *===*   
|       |   |           |   |       |   |           |           |   
*===*   *   *===*   *===*   *===*===*   *===*   *===*===*   *===*   
|       |           |           |           |   |       |       |   
*   *   *===*===*===*   *===*   *   *===*   *===*   *   *===*   *   
|   |                   |               |           |           |   
*===*===*===*===*===*===*===*===*===*===*===*===*===*===*===*===*   
                                                                    
