*===*===*===*===*===*===*===*===*===*===*===*===*===*===*===*===*===*===*   
|               |   |           |   |       |   |   |                   |   
*   *   *   *   *   *===*===*   *   *   *   *   *   *   *   *   *   *   *   
|               |           |           |   |   |   |                   |   
*   *   *   *   *   *===*   *===*   *   *   *   *   *   *   *   *   *   *   
|               |   |               |               |                   |   
*   *   *   *   *   *   *===*   *   *===*===*===*===*   *   *   *   *   *   
|               |   |   |       |   |   |   |       |                   |   
*   *   *   *   *   *   *   *===*   *   *   *   *   *   *   *   *   *   *   
|               |                   |   |       |   |                   |   
*   *   *   *   *===*   *   *===*===*   *===*   *   *   *   *   *   *   *   
|               |       |                       |   |                   |   
*   *   *   *   *   *===*   *===*   *===*   *   *   *   *   *   *   *   *   
|               |           |       |   |   |   |   |                   |   
*   *   *   *   *===*===*===*   *   *===*   *   *   *   *   *   *   *   *   
|               |       |       |       |       |   |                   |   
*   *   *   *   *   *   *   *===*   *===*===*===*   *   *   *   *   *   *   
|               |           |       |               |                   |   
*   *   *   *===*===*===*===*===*===*===*===*===*===*   *   *   *   *   *   
|                                                                       |   
*   *   *   *   *   *   *   *   *   *   *   *   *   *   *   *   *   *   *   
|                                                                       |   
*   *   *   *   *   *   *   *   *   *   *   *   *   *   *   *   *   *   *   
|                                                                       |   
*   *   *   *   *   *   *   *   *   *   *   *   *   *   *   *   *   *   *   
|                                                                       |   
*   *   *   *   *   *   *   *   *   *   *   *   *   *   *   *   *   *   *   
|                                                                       |   
*   *   *   *   *   *   *   *   *   *   *   *   *   *   *   *   *   *   *   
|                                                                       |   
*   *   *   *   *   *   *   *   *   *   *   *   *   *   *   *   *   *   *   
|                                                                       |   
*   *   *   *   *   *   *   *   *   *   *   *   *   *   *   *   *   *   *   
|                                                                       |   
*   *   *   *   *   *   *   *   *   *   *   *   *   *   *   *   *   *   *   
|   |                                                                   |   
*===*===*===*===*===*===*===*===*===*===*===*===*===*===*===*===*===*===*   
                                                                            
