*===*===*===*===*===*===*===*===*===*===*===*===*===*===*===*===*===*   
|       |               |       |           |               |       |   
*   *   *===*===*===*   *   *===*   *===*   *   *===*===*===*   *   *   
|   |                       |   |       |                       |   |   
*   *===*   *===*===*   *===*===*   *===*===*   *===*===*   *===*   *   
|   |       |       |   |       |   |       |   |       |       |   |   
*   *   *===*   *   *   *   *===*   *===*   *   *   *   *===*   *   *   
|   |       |       |   |       |   |       |   |       |       |   |   
*   *===*   *===*   *   *===*   *   *   *===*   *   *===*   *===*   *   
|       |           |   |       |   |       |   |           |       |   
*   *===*   *===*   *   *   *===*   *===*   *   *   *===*   *===*   *   
|       |       |   |   |       |   |       |   |   |       |       |   
*===*   *===*   *   *   *===*   *   *   *===*   *   *   *===*   *===*   
|           |       |           |   |           |       |           |   
*   *===*   *===*===*===*===*===*   *===*===*===*===*===*   *===*   *   
|   |           |   |           |               |   |           |   |   
*   *   *===*   *   *   *===*   *===*   *===*   *   *   *===*   *   *   
|                               |                                   |   
*===*===*===*===*===*===*===*===*===*===*===*===*===*===*===*===*===*   
|                                                                   |   
*   *   *   *   *   *   *   *   *   *   *   *   *   *   *   *   *   *   
|                                                                   |   
*   *   *   *   *   *   *   *   *   *   *   *   *   *   *   *   *   *   
|                                                                   |   
*   *   *   *   *   *   *   *   *   *   *   *   *   *   *   *   *   *   
|                                                                   |   
*   *   *   *   *   *   *   *   *   *   *   *   *   *   *   *   *   *   
|                                                                   |   
*   *   *   *   *   *   *   *   *   *   *   *   *   *   *   *   *   *   
|                                                                   |   
*   *   *   *   *   *   *   *   *   *   *   *   *   *   *   *   *   *   
|   |                                                               |   
*   *   *   *   *   *   *   *   *   *   *   *   *   *   *   *   *   *   
|   |                                                               |   
*===*===*===*===*===*===*===*===*===*===*===*===*===*===*===*===*===*   
                                                                        
